customer_id,income,monthly_spend,age,credit_score,default_flag,spend_income_ratio,age_credit_ratio,disposable_income
1,10270,2070,49,582,0,0.20155793573515093,0.08419243986254296,8200
2,3860,5556,21,326,0,1.4393782383419689,0.06441717791411043,-1696
3,8390,6081,28,525,0,0.7247914183551848,0.05333333333333334,2309
4,8191,3190,34,576,0,0.389451837382493,0.059027777777777776,5001
5,8734,4340,55,583,1,0.49690863292878407,0.09433962264150944,4394
6,9265,1528,41,780,0,0.16492174851592012,0.052564102564102565,7737
7,3466,1002,22,752,0,0.2890940565493364,0.02925531914893617,2464
8,7426,4993,51,815,0,0.6723673579315917,0.06257668711656442,2433
9,8578,1370,23,846,0,0.15971088831895547,0.027186761229314422,7208
10,11322,4988,39,491,0,0.4405582052640876,0.07942973523421588,6334
11,4685,706,28,348,0,0.15069370330843115,0.08045977011494253,3979
12,3769,5634,33,811,0,1.4948262138498276,0.040690505548705305,-1865
13,9949,6477,50,316,0,0.6510202030354809,0.15822784810126583,3472
14,5433,1984,26,471,0,0.36517577765507087,0.055201698513800426,3449
15,8311,1363,23,519,0,0.16399951871014318,0.04431599229287091,6948
16,8051,3290,33,457,0,0.40864488883368527,0.07221006564551423,4761
17,9420,1063,46,776,0,0.11284501061571126,0.059278350515463915,8357
18,4184,5616,20,345,0,1.3422562141491396,0.057971014492753624,-1432
19,7555,4691,37,672,0,0.6209133024487095,0.05505952380952381,2864
20,6385,6519,53,817,1,1.0209866875489428,0.06487148102815178,-134
21,9396,2257,36,398,0,0.24020859940400172,0.09045226130653267,7139
22,11666,6874,43,336,0,0.5892336704954568,0.12797619047619047,4792
23,5558,2178,20,579,0,0.3918675782655632,0.03454231433506045,3380
24,10849,3742,36,648,0,0.3449165821734722,0.05555555555555555,7107
25,5047,5136,37,796,0,1.017634238161284,0.04648241206030151,-89
26,5747,1559,49,601,0,0.2712719679832956,0.08153078202995008,4188
27,3189,5779,24,480,1,1.8121668234556287,0.05,-2590
28,5734,2222,58,398,0,0.38751307987443323,0.1457286432160804,3512
29,6005,3814,50,415,0,0.6351373855120733,0.12048192771084337,2191
30,7658,3657,57,490,0,0.4775398276312353,0.11632653061224489,4001
31,4899,6415,56,552,0,1.3094509083486425,0.10144927536231885,-1516
32,10734,3125,35,460,0,0.291130985653065,0.07608695652173914,7609
33,4267,3229,57,555,1,0.7567377548629013,0.10270270270270271,1038
34,4528,2097,18,622,0,0.4631183745583039,0.028938906752411574,2431
35,6556,3560,28,427,1,0.5430140329469189,0.06557377049180328,2996
36,6890,3193,45,317,1,0.46342525399129175,0.14195583596214512,3697
37,11838,5391,42,622,0,0.4553978712620375,0.06752411575562701,6447
38,8393,5647,40,587,0,0.6728225902537829,0.06814310051107325,2746
39,11792,6239,48,454,0,0.5290875169606513,0.10572687224669604,5553
40,11433,4127,47,789,0,0.36097262310854544,0.059569074778200254,7306
41,10513,1863,59,685,0,0.17720916959954341,0.08613138686131387,8650
42,5612,2481,52,403,0,0.44208838203848894,0.12903225806451613,3131
43,10041,5950,24,692,0,0.5925704611094512,0.03468208092485549,4091
44,9235,2163,33,545,0,0.23421765024363833,0.060550458715596334,7072
45,8486,2029,43,475,1,0.23909969361300967,0.09052631578947369,6457
46,10099,2538,19,338,0,0.25131201109020695,0.05621301775147929,7561
47,3775,6092,18,776,1,1.6137748344370861,0.023195876288659795,-2317
48,11226,3802,29,837,0,0.33867806876892925,0.03464755077658303,7424
49,6152,2737,22,707,0,0.4448959687906372,0.031117397454031116,3415
50,4585,6004,54,824,0,1.3094874591057797,0.06553398058252427,-1419
51,6943,5996,49,805,0,0.8636036295549474,0.06086956521739131,947
52,10555,1806,26,335,1,0.17110374230222644,0.07761194029850746,8749
53,6073,4529,58,319,0,0.7457599209616335,0.18181818181818182,1544
54,4021,3175,52,620,1,0.7896045759761253,0.08387096774193549,846
55,6843,5568,36,811,0,0.8136782113108286,0.04438964241676942,1275
56,10989,6364,33,699,0,0.5791245791245792,0.04721030042918455,4625
57,9873,1782,20,770,0,0.1804922515952598,0.025974025974025976,8091
58,8675,1209,37,442,1,0.13936599423631124,0.083710407239819,7466
59,3161,6075,41,391,1,1.921860170832015,0.10485933503836317,-2914
60,7297,6030,50,653,0,0.8263670001370427,0.07656967840735068,1267
61,3995,5244,41,350,0,1.3126408010012516,0.11714285714285715,-1249
62,10629,4913,28,489,0,0.4622259855113369,0.05725971370143149,5716
63,4016,4248,25,424,0,1.0577689243027888,0.0589622641509434,-232
64,10869,5853,53,449,1,0.5385040022081148,0.11804008908685969,5016
65,9439,5279,55,613,1,0.5592753469647208,0.08972267536704731,4160
66,10892,1163,57,641,0,0.10677561513037091,0.08892355694227769,9729
67,9863,2498,37,604,0,0.2532697962080503,0.061258278145695365,7365
68,10916,3945,52,353,0,0.36139611579333086,0.14730878186968838,6971
69,11529,4243,42,743,0,0.3680284499956631,0.05652759084791386,7286
70,3878,6227,52,563,1,1.6057246003094379,0.09236234458259325,-2349
71,7887,1995,42,352,0,0.25294788893115255,0.11931818181818182,5892
72,7859,3804,46,304,1,0.4840310472070238,0.1513157894736842,4055
73,9331,4263,35,402,0,0.4568642160540135,0.08706467661691543,5068
74,11571,5732,63,495,1,0.49537637196439377,0.12727272727272726,5839
75,11684,2353,35,649,0,0.20138651146867512,0.053929121725731895,9331
76,10208,6116,19,346,0,0.5991379310344828,0.05491329479768786,4092
77,8276,5159,52,568,1,0.6233687771870469,0.09154929577464789,3117
78,5062,1791,33,669,0,0.35381272224417226,0.04932735426008968,3271
79,3064,4081,58,405,0,1.3319190600522193,0.14320987654320988,-1017
80,11006,3957,53,419,1,0.3595311648191895,0.12649164677804295,7049
81,5568,2136,50,357,1,0.38362068965517243,0.1400560224089636,3432
82,8463,4196,21,645,0,0.4958052699988184,0.03255813953488372,4267
83,5027,3499,50,773,0,0.6960413765665406,0.0646830530401035,1528
84,5695,3652,31,416,0,0.6412642669007902,0.07451923076923077,2043
85,8258,1198,38,426,0,0.14507144587067086,0.0892018779342723,7060
86,8618,2660,37,692,0,0.30865630076583894,0.05346820809248555,5958
87,9736,4597,25,357,0,0.47216516023007393,0.0700280112044818,5139
88,3391,5237,24,812,0,1.5443821881450899,0.029556650246305417,-1846
89,8892,6863,20,395,0,0.7718173639226271,0.05063291139240506,2029
90,6561,6185,34,417,0,0.9426916628562719,0.0815347721822542,376
91,9184,1354,50,787,0,0.14743031358885017,0.06353240152477764,7830
92,6099,6355,29,536,0,1.0419740941137892,0.054104477611940295,-256
93,9278,3974,39,571,0,0.4283250700582022,0.06830122591943957,5304
94,11392,6257,39,488,0,0.5492450842696629,0.07991803278688525,5135
95,6104,5749,63,746,0,0.9418414154652687,0.08445040214477212,355
96,10215,5672,47,546,1,0.5552618697993147,0.08608058608058608,4543
97,5454,2207,55,375,0,0.40465713237990464,0.14666666666666667,3247
98,11996,3277,55,453,0,0.2731743914638213,0.12141280353200883,8719
99,5731,6291,62,734,0,1.0977141860059327,0.08446866485013624,-560
100,11154,2233,25,385,0,0.20019723865877712,0.06493506493506493,8921
